# ttfm tag			bmode tag
AccessionNumber               	AccessionNumber               
BitsAllocated                 	BitsAllocated                 
BitsStored                    	BitsStored                    
CineRate                      	CineRate                      
Columns                       	Columns                       
ContentDate                   	ContentDate                   
ContentTime                   	ContentTime                   
DeviceSerialNumber            	DeviceSerialNumber            
EffectiveDuration             	EffectiveDuration             
FrameIncrementPointer         	FrameIncrementPointer         
FrameTime                     	FrameTime                     
HighBit                       	HighBit                       
ImageComments                 	ImageComments                 
ImageType                     	ImageType                     
InstanceNumber                	InstanceNumber                
InstitutionAddress            	InstitutionAddress            
InstitutionName               	InstitutionName               
Laterality                    	Laterality                    
LossyImageCompression         	LossyImageCompression         
Manufacturer                  	Manufacturer                  
ManufacturerModelName         	ManufacturerModelName         
Modality                      	Modality                      
NumberOfFrames                	NumberOfFrames                
PatientBirthDate              	PatientBirthDate              
PatientComments               	PatientComments               
PatientID                     	PatientID                     
PatientName                   	PatientName                   
PatientOrientation            	PatientOrientation            
PatientSex                    	PatientSex                    
PatientSize                   	PatientSize                   
PatientWeight                 	PatientWeight                 
PerformingPhysicianName       	PerformingPhysicianName       
PhotometricInterpretation     	PhotometricInterpretation     
PixelData                     	PixelData                     
PixelRepresentation           	PixelRepresentation           
PlanarConfiguration           	PlanarConfiguration           
PreferredPlaybackSequencing   	PreferredPlaybackSequencing   
RecommendedDisplayFrameRate   	RecommendedDisplayFrameRate   
ReferringPhysicianName        	ReferringPhysicianName        
Rows                          	Rows                          
SOPClassUID                   	SOPClassUID                   
SOPInstanceUID                	SOPInstanceUID                
SamplesPerPixel               	SamplesPerPixel               
SequenceOfUltrasoundRegions   	SequenceOfUltrasoundRegions   
SeriesDate                    	SeriesDate                    
SeriesInstanceUID             	SeriesInstanceUID             
SeriesNumber                  	SeriesNumber                  
SeriesTime                    	SeriesTime                    
SoftwareVersions              	SoftwareVersions              
SpecificCharacterSet          	SpecificCharacterSet          
StationName                   	StationName                   
StudyDate                     	StudyDate                     
StudyDescription              	StudyDescription              
StudyID                       	StudyID                       
StudyInstanceUID              	StudyInstanceUID              
StudyTime                     	StudyTime                     
